################
#         O ####
#         ######
#  O          ##
######        ##
###O          ##
###     X     ##
#       P     ##
#  X    X     ##
#             ##
################
 